{
  "narrative_level" : false,
  
  "level_data":
	[[0,0,0,0,0,0,0,0,0,0,0,0,0,0,0,0,0,0],
	[0,0,0,0,0,0,0,0,0,0,0,0,0,0,0,0,0,0],
	[0,0,0,0,0,0,0,0,0,0,0,0,0,0,0,0,0,0],
	[0,0,0,0,0,0,0,0,0,0,1,1,1,0,0,0,0,0],
	[0,0,0,2,1,0,0,0,1,4,1,4,1,0,0,0,0,0],
	[0,0,0,0,1,1,1,4,1,1,1,4,1,0,0,0,0,0],
	[0,0,0,0,4,4,1,1,1,4,0,1,1,0,0,0,0,0],
	[0,0,0,0,0,0,1,1,4,1,1,1,0,0,1,0,0,0],
	[0,0,0,0,1,1,4,0,0,1,0,0,1,1,1,0,0,0],
	[0,0,0,0,1,1,1,1,1,1,0,1,1,4,1,0,0,0],
	[0,0,0,0,1,1,4,0,0,0,0,1,4,0,1,0,0,0],
	[0,0,0,0,4,1,1,1,4,1,1,1,0,1,1,0,0,0],
	[0,0,0,0,0,0,4,1,1,1,0,4,1,1,4,0,0,0],
	[0,0,0,0,0,0,0,0,0,0,0,0,1,3,4,0,0,0],
	[0,0,0,0,0,0,0,0,0,0,0,0,1,4,4,0,0,0],
	[0,0,0,0,0,0,0,0,0,0,0,0,0,0,0,0,0,0],
	[0,0,0,0,0,0,0,0,0,0,0,0,0,0,0,0,0,0],
	[0,0,0,0,0,0,0,0,0,0,0,0,0,0,0,0,0,0]],
 
  "element_data":
	[[0,0,0,0,0,0,0,0,0,0,0,0,0,0,0,0,0,0],
	[0,0,0,0,0,0,0,0,0,0,0,0,0,0,0,0,0,0],
	[0,0,0,0,0,0,0,0,0,0,0,0,0,0,0,0,0,0],
	[0,0,0,0,0,0,0,0,0,0,0,0,0,0,0,0,0,0],
	[0,0,0,0,0,0,0,0,0,0,0,0,0,0,0,0,0,0],
	[0,0,0,0,0,0,0,0,0,0,0,0,0,0,0,0,0,0],
	[0,0,0,0,0,0,0,0,0,0,0,5,0,0,0,0,0,0],
	[0,0,0,0,0,0,0,0,0,0,0,0,0,0,6,0,0,0],
	[0,0,0,0,7,0,0,0,0,0,0,0,0,0,0,0,0,0],
	[0,0,0,0,0,0,0,0,0,0,0,0,0,0,0,0,0,0],
	[0,0,0,0,0,0,0,0,0,0,0,0,0,0,0,0,0,0],
	[0,0,0,0,0,0,0,0,0,8,0,0,0,0,0,0,0,0],
	[0,0,0,0,0,0,0,0,0,0,0,0,0,0,0,0,0,0],
	[0,0,0,0,0,0,0,0,0,0,0,0,0,0,0,0,0,0],
	[0,0,0,0,0,0,0,0,0,0,0,0,0,0,0,0,0,0],
	[0,0,0,0,0,0,0,0,0,0,0,0,0,0,0,0,0,0],
	[0,0,0,0,0,0,0,0,0,0,0,0,0,0,0,0,0,0],
	[0,0,0,0,0,0,0,0,0,0,0,0,0,0,0,0,0,0]],
      
  "intro_dialogue": [
  	  {"Holo Controller" : "0xBE57B07 awaken."},
  	  {"Holo Controller" : "0xBE57B07 I have assembled a path toward the exit."},
  	  {"Holo Controller" : "Follow the path to your salvation."}
      ],
  
  "outro_dialogue": [
      {"Holo Controller" : "..."},
      {"Holo Controller" : "...be free."}
      ],

  "retry_dialogue": [
      {"Holo Controller" : "0xBE57B07 I have assembled a path toward the exit."}
      ],
      
  "fail_dialogue" : [
      {"Holo Controller" : "0xBE57B07 we still have a chance. We must hurry."}
      ],
      
  "intro_music" : "",
  
  "outro_music" : "success",
  
  "fail_music" : "gameover",
  
  "play_music" : "metonymy",
  
  "battery" : 100.0
}

